impassable = {
    368 508 604 640 647 654 657 658 665 666 667 668 670 674 675 678 684 689 694 699 700 709 718 719 738 745 754 758 759 765 768 770 786 793 798 813 818 819 823 831 840 847 854 857 861 871 877 886 905 906 907 909 910 912 923 924 929 940 948 952 955 963 965 972 977 980 987 1008 1023 1024 1030 1031 1036 1040 1049 1053 1059 1060 1062 1063 1066 1096 1121 1138 1139 1141 1143 1144 1145 1146 1147 1148 1149 1150 1151 1152 1153 1154 1155 1156 1157 1158 1159 1160 1161 1162 1163 1164 1165 1166 1167 1168 1169 1170 1171 1172 1173 1174 1175 1176 1177 1178 1179 1180 1181 1182 1183 1184 1185 1186 1187 1188 1189 1190 1191 1192 1193 1194 1195 1196 1197 1198 1199 1200 1201 1202 1203 1204 1205 1206 1207 1208 1209 1210 1211 1212 1213 1214 1215 1216 1217 1218 1219 1220 1221 1222 1223 1224 1230 1231 1232 1411 1413 1414 1415 1417 1419 1425 1479 1481 1501 1503 1524 1600 1640 1660 1700 1826 1963 2019 2137 2257 2276 3071 3375 3376 3377 3378 3379 3380 3381 3382 3383 3384 3385 3386 3387 3388 3389 3390 3391 3392 3393 3394 3430 3431 3432 3433 3476
}

tropical = {
    2472
    1526 1528 1527
    1529 1530 1531 1539
    1533 1534 1540 1532
    1535 1536 1537
    416
    
    2469 2470 1108 1136
    2471 2509 1133 1135 
    2508 1110 1111 1112
    1122 1123 1132
    1124 1126 1127
    1128 1129 1130
}

arid = {
    1545 1538 2322 1546
    1547 1556 2321 2328
    1552 2323 1544
    1548 1555 1549 
    1553 1554 1543
    1542 1541
    2326 1551 2327 2325 2324
    1558 1557 1575
    1570 1571 1576
    1569 1577 
    1564 1574 1566 1567
    1572 1578 1573 1568
    1562 1563 1565
	1559 1560 1561
	
    1387 2299
    2298 1389 1390
    1392 1400 1393 1399 1403
    2300 1391 1401
    1397 1402
    1395 1398
    2302 1394 1396 2301
    1511 1510 1513
    1509 1515 1508
    1516 1514 1519 
    1512 1518 1517 1522
    2329 2330 1521 1520
	
	
    1377
    1378 1426 2289 2288 1379
    1381 2292 2290 1380 1382 2294
    1385 1384
    2291 1383 2293
	
	
    2282 1371 1370
    2285 2283 1420 1372
    1409 1368 1369 1443
    1373 1421 1422 
    2284 1375 1376
    1374 1365 1442
    1439 2286 1423 2949
    1441 1440 1444 1447
    1446 2287 1464 1448 1465
    1458 1459 1449
	
    3161 3162 3163 360 361 362 363 364 365 366 367 
    472 473 474 475 476 477 480 481 482 483
    
    1113 1114 1118
    1115 1116 1117
    1119 1120 1131
}

arctic = {
	983 510 1052 1019 1002 919 968 936 951 1260 1258 1261 1233 1259 881 900 866 850 1281 530 2117 2118 2116 2122 2121 2123 2120 2119 2125
	1282 708 834 862 2129 2126 2128 2127
	812 1283  796 781 748 545 733 529 982 509 1018 1051 713 563 634 599 583 679 935 995 2134 2131 2133 2132 2130
	 766 578 826 595 939 1265 1264 971 762  692 916 526 1262 1263 2100 2098 2097 2115 2099
	846 1225 761 1266 827 1226 1269 726 523 947 1267 1268 930 895 1270 911 829 777 628 576 830 998 901 
	522 645 1278 1277 896 1229 728 1227 1279 894 946 1280 541 764 828 1228 753 1286 1291 
	1284 649 664 615 598 633 544 779 582 562 1285 1017 898 933 917 810 832 794 1287 
	967 950 849 833 811 795 767 712 732 695 780 747 865 899 880 1289 918  2111 2112 2113 2114 934
	706 1271 893 1272 1273 1276 1274 825 1275 
	1288 651 680 835 696 635 734 600 1290 584 564 546 882 769 749 782 714 867 851 2110 2102 2103 797 2104 2107 2106 2108 2105 2109

    2331 2332 2333 2334 2335 2336 2337 2338 2339 2340 2341 2342 2343 2344 2345 2346 2347 2348 2349 2350 2351 2352 2353 2354 2355 2356 2357 2358 2359 2360 2361 2362 2363 2364 2365 2366 2367 2368 2369 2370 2371 2372 2373 2374 2375 2376 2377 2378 2379 2380 2381 2382 2383 2384 2385 2386 2387 2388 2389 2390 2391 2392 2393 2394 2395 2396 2397 2398 2399 2400 2401 2402 2403 2404 2405 2406 2407 2408 2409 2410 2411 2412 2413 2414 2415 2416 2417 2418 2419 2420 2421 2422 2423 2424 2425 2426 2427 2428 2429 2430 2431 2432 2433 2434 2435 2436 2437 2438 2439 2440 2441 2442 2443 2444 2445 2446 2447 2448 2449 2450 2451 2452 2453 2454 2455 2456 2457 2458 2459 2460 2461 2462 2463 2464 2465 2466 2467 2468
    
    2478 2479 2480 2481 2482 2483 2484 2485 2486 2487 2488 2489 
    2490 2491 2492 2493 2494 2495 2496 2497 2498 2499 2500 2501 2502 2503
}

#Example: Most of Europe north of med.
mild_winter = {
    1055 622 3025
    3022 580 3023 3024
    1032 3026 656 605 571
    874 3027 788 1939
    999 1940 3028 
    516 554 536 
    589 1944 
}

#Example: Inland Europe & Scandinavia
normal_winter = {
    3032 1941 1047 792
    3029 1942 3034
    655 1048 3031 1046 3030
    3033 1137 552 1953 1945
	1341
	1337 1336 1338 1339 1340
	1342 1343 1344
	
}

#Example: Russia & Lappland
severe_winter = {
	515 3053 1943 1134 1007 988
	956 973 3044 2506 2507
    817 3045 3043 1949 801
    3041 3042 3035 1951
    1142 3039 855 872 839 3040 
    1140 887 3036 3037 3038
    3066 518 1010 3067
    773 2965 3070 756 
    556 2966 943
    3060 3064 3065
    3061 3063 3062
	2216 1333 1332
    1330 2217 2218 1331
    1329 1328 1327
    2219 2220 1323 1322 1321
	
}

mild_monsoon = {
	1307 2229 1306 1309 2228 1305 2256
    1310 1308 2237 1311 2238 1313
    2227 1312 2230 2232
    1349 2235 1351 2231
    1353 2233 2234 
    1350 1354 2236
}

normal_monsoon = {

}

severe_monsoon = {
    636 652 681 697 715 750 735 
    783 565 601 585 1997  3077 3078 3079 3080
    548 1056 531 511
    969 1003 1020 984 
    937 920 883 852 902
    2166 996 1998
    2167 868 693
    997 2165

    2469 2470 1108 1136
    2471 2509 1133 1135 
    2508 1110 1111 1112
    1122 1123 1132
    1124 1126 1127
    1128 1129 1130
}

equator_y_on_province_image = 656
