#-------------------------------------------
# Eastern Kingdoms
#-------------------------------------------
continent_eastern_kingdoms = {
	505 506 507 511 515 516 517 518 519 520 521 525 527 528 531 533 536 537 538 539 540 542 543 547 548 550 552 553 554 556 557 558 560 561 565 567 570 571 574 575 580 581 585 586 587 589 591 592 593 594 596 597 601 602 603 605 606 607 608 609 610 612 613 614 618 619 622 623 624 625 626 627 629 630 631 632 636 637 638 639 641 642 643 644 646 648 650 652 653 655 656 659 660 661 662 663 669 671 672 673 676 677 681 682 683 685 686 687 688 690 691 693 697 698 701 702 703 704 705 707 710 711 715 716 717 720 721 722 723 724 725 727 729 730 731 735 736 737 739 740 741 742 743 744 746 750 751 752 755 756 757 760 763 771 772 773 774 775 776 778 783 784 785 787 788 789 790 791 792 799 800 801 802 803 804 805 806 807 808 809 814 815 816 817 820 821 822 824 836 837 838 839 841 842 843 844 845 848 852 853 855 856 858 859 860 863 864 868 869 870 872 873 874 875 876 878 879 883 884 885 887 888 889 890 891 892 897 902 903 904 908 913 914 915 920 921 922 925 926 927 928 931 932 937 938 941 942 943 944 945 949 953 954 956 957 958 959 960 961 962 964 966 969 970 973 974 975 976 978 979 981 984 985 986 988 989 990 991 992 993 994 996 997 999 1000 1003 1004 1005 1007 1009 1010 1011 1012 1013 1015 1016 1020 1021 1022 1025 1026 1027 1028 1029 1032 1033 1034 1035 1037 1038 1039 1041 1042 1043 1044 1045 1046 1047 1048 1050 1054 1055 1056 1057 1058 1061 1064 1125 1134 1137 1140 1142 1478 1480 1500 1502 1504 1505 1506 1507 1523 1525 1601 1618 1639 1653 1659 1741 1742 1743 1744 1745 1746 1747 1748 1749 1750 1751 1752 1753 1754 1755 1756 1757 1758 1759 1760 1761 1762 1763 1764 1765 1766 1767 1768 1769 1770 1771 1772 1825 1827 1830 1831 1844 1875 1916 1921 1922 1923 1924 1925 1926 1927 1928 1929 1930 1931 1932 1933 1934 1935 1936 1937 1938 1939 1940 1941 1942 1943 1944 1945 1946 1947 1948 1949 1950 1951 1952 1953 1954 1955 1956 1957 1958 1959 1960 1961 1962 1964 1965 1966 1967 1968 1969 1970 1971 1972 1973 1974 1975 1976 1977 1978 1979 1980 1981 1982 1983 1984 1985 1986 1987 1988 1989 1990 1991 1992 1993 1994 1995 1996 1997 1998 1999 2000 2001 2002 2003 2004 2005 2006 2007 2008 2009 2010 2011 2012 2013 2014 2015 2016 2017 2018 2020 2021 2022 2023 2024 2025 2026 2027 2096 2124 2138 2139 2140 2141 2142 2143 2144 2145 2146 2147 2148 2149 2150 2151 2152 2153 2154 2155 2156 2157 2158 2159 2160 2161 2162 2163 2164 2165 2166 2167 2168 2169 2170 2171 2172 2173 2174 2175 2176 2177 2178 2179 2180 2181 2182 2183 2184 2185 2186 2187 2188 2189 2190 2191 2192 2193 2194 2195 2196 2197 2198 2199 2200 2202 2203 2204 2205 2206 2207 2208 2209 2210 2211 2212 2213 2214 2215 2473 2474 2475 2476 2477 2505 2506 2507 2510 2511 2512 2513 2514 2515 2517 2518 2519 2520 2954 2955 2956 2957 2958 2959 2960 2961 2962 2963 2964 2965 2966 2967 2968 2969 2970 2971 2972 2973 2974 2975 2976 2977 2978 2979 2980 2981 2982 2983 2984 2985 2986 2987 2988 2989 2990 2991 2992 2993 2994 2995 2996 2997 2998 2999 3000 3001 3002 3003 3004 3005 3006 3007 3009 3010 3011 3012 3013 3014 3015 3016 3017 3018 3019 3020 3021 3022 3023 3024 3025 3026 3027 3028 3029 3030 3031 3032 3033 3034 3035 3036 3037 3038 3039 3040 3041 3042 3043 3044 3045 3047 3048 3049 3050 3051 3052 3053 3054 3055 3056 3057 3058 3059 3060 3061 3062 3063 3064 3065 3066 3067 3068 3069 3070 3072 3073 3074 3075 3077 3078 3079 3080 3154 3155 3156 215
    1001 1006 1208 2516
    
    # Wasteland
    923 924 929 940 955 963 965 972 948 977 980 987 1023 1024 1036 1031 1030 1040 1049 1053 1059 1060 1062 1063 1066 1141 1143 1146 1145 1147 1144 1149 1152 1151 1153 1155 1156 1158 1157 1159 1160 1161 1148 1150 1164 1163 1162 1166 1165 1167 1169 1168 1170 1171 1172 1173 1176 1175 1177 1178 1179 1180 1185 1182 1181 1184 1183 1186 1187 1188 1189 1190 1191 1192 1193 1194 1195 1198 1197 1196 1174 1199 1201 1203 1205 1204 1202 
    952 1154 1200
}

#-------------------------------------------
# Kalimdor
#-------------------------------------------
continent_kalimdor = {
	360 361 362 363 364 365 366 367 416 448 472 473 474 475 476 477 480 481 482 483 568 569 572 1014 1065 1067 1068 1069 1070 1071 1072 1073 1074 1075 1076 1077 1078 1079 1080 1081 1082 1083 1084 1085 1086 1087 1088 1089 1090 1091 1092 1093 1094 1095 1234 1235 1236 1237 1238 1239 1240 1241 1242 1243 1244 1245 1246 1247 1248 1249 1250 1251 1252 1253 1254 1255 1256 1257 1292 1293 1294 1295 1296 1297 1298 1299 1300 1301 1302 1303 1304 1305 1306 1307 1308 1309 1310 1311 1312 1313 1314 1315 1316 1317 1318 1319 1320 1321 1322 1323 1324 1325 1326 1327 1328 1329 1330 1331 1332 1333 1334 1335 1336 1337 1338 1339 1340 1341 1342 1343 1344 1345 1346 1347 1348 1349 1350 1351 1352 1353 1354 1355 1357 1358 1359 1360 1361 1362 1363 1364 1365 1366 1367 1368 1369 1370 1371 1372 1373 1374 1375 1376 1377 1378 1379 1380 1381 1382 1383 1384 1385 1386 1387 1388 1389 1390 1391 1392 1393 1394 1395 1396 1397 1398 1399 1400 1401 1402 1403 1404 1405 1406 1407 1408 1409 1410 1412 1416 1418 1420 1421 1422 1423 1424 1426 1427 1428 1429 1430 1431 1432 1433 1434 1436 1438 1439 1440 1441 1442 1443 1444 1445 1446 1447 1448 1449 1450 1451 1452 1453 1454 1455 1456 1457 1458 1459 1460 1461 1462 1463 1464 1465 1467 1468 1469 1470 1471 1472 1473 1474 1475 1476 1477 1482 1483 1484 1485 1486 1487 1488 1489 1490 1491 1492 1493 1494 1495 1496 1497 1498 1499 1508 1509 1510 1511 1512 1513 1514 1515 1516 1517 1518 1519 1520 1521 1522 1526 1527 1528 1529 1530 1531 1532 1533 1534 1535 1536 1537 1538 1539 1540 1541 1542 1543 1544 1545 1546 1547 1548 1549 1550 1551 1552 1553 1554 1555 1556 1557 1558 1559 1560 1561 1562 1563 1564 1565 1566 1567 1568 1569 1570 1571 1572 1573 1574 1575 1576 1577 1578 1579 1580 1581 1582 1583 1584 1585 2135 2136 2201 2216 2217 2218 2219 2220 2221 2222 2223 2224 2225 2226 2227 2228 2229 2230 2231 2232 2233 2234 2235 2236 2237 2238 2239 2240 2241 2242 2243 2244 2245 2246 2247 2248 2249 2250 2251 2252 2253 2254 2255 2256 2258 2259 2260 2261 2262 2263 2264 2265 2266 2267 2268 2269 2270 2271 2272 2273 2274 2275 2277 2278 2279 2280 2281 2282 2283 2284 2285 2286 2287 2288 2289 2290 2291 2292 2293 2294 2295 2296 2297 2298 2299 2300 2301 2302 2303 2304 2305 2306 2307 2308 2309 2310 2311 2312 2313 2314 2315 2316 2317 2318 2319 2320 2321 2322 2323 2324 2325 2326 2327 2328 2329 2330 2504 2949 2950 2951 2952 2953 3161 3162 3163 3164 3165 3166 3167 3168 3169 3170 3194 3195 3197 3198 3199 3200 3202 3203 3204 3205 3206 3215 3216 3217 3218 3219 3267 3325 3326 3327 3328 3329 3330 3331 3332 3333 3334 3335 3336 3337 3338 3339 3340 3341 3342 3344 3345 3346 3347 3348 3349 3350 3351 3352 3353 3354 3355 3356 3357 3358 3360 3361 3362 3363 3364 3365 3366 3367 3368 3369 3370 3371 3372 3373 3374 3395 3396 3397 3398 3399 3400 3401 3402 3403 3404 3405 3406 3407 3408 3409 3410 3411 3412 3413 3414 3415 3416 3417 3418 3419 3420 3421 3422 3423 3424 3425 3426 3427 3428 3429 3434 3435 3436 3437 3438 3439 3440 3441 3442 3443 3444 3445 3446 3447 3448 3449 3451 3452 3453 3454 3455 3456 3457 3458 3459 3460 3461 3462 3463 3464 3465 3466 3467 3468 3469 3470 3471 3472 3473 3474 3475 3477 3478 3479 3480 3481 3482 3483 3484 3485 3486 3487 3488 3489 3490 3491 3492 3493 3494 3495 3496 3497 3498 3499 3500 3501 3502 3503 3504 3505 3506 3507 3508 3509 3510 3511 3512 3513
    3634 3635 3636 3637 3638 3639 3640 3641 3642 3643 3644 3645 3646 3647 3648 3649 3650 3651 3652 3653 3654 3655 3656 3657 3658 3659 3660 3661 3662 
    3663 3664 3665 3666 3667 3668 3669 3670 3671 3672 3673 3674 3675 3676 3677 3678 3679 3680 3681 3682 3683 3684 3685 3686 3687 3688 3689 3690 3691 3692 3693 3694 3695
    
    # Wasteland
    604 1138 1139 3377 1481 1419 1479 1600 1503 1501 1826 2276 3378 3379 3381 3376 3382 2257 3383 3385 3384 3386 3387 3388 3433 1121 3430 3432 3431 3394 3393 3392 3389 3390 3391 508 1963 3071 1700 1096 1524 1425 1414 1415 1413 1411 368 1660 1008 2019 1640 2137 3380
}

#-------------------------------------------
# Northrend
#-------------------------------------------
continent_northrend = {
	509 510 522 523 526 529 530 541 544 545 546 562 563 564 576 578 582 583 584 595 598 599 600 615 628 633 634 635 645 649 651 664 679 680 692 695 696 706 708 712 713 714 726 728 732 733 734 747 748 749 753 761 762 764 766 767 769 777 779 780 781 782 794 795 796 797 810 811 812 825 826 827 828 829 830 832 833 834 835 846 849 850 851 862 865 866 867 880 881 882 893 894 895 896 898 899 900 901 911 916 917 918 919 930 933 934 935 936 939 946 947 950 951 967 968 971 982 983 995 998 1002 1017 1018 1019 1051 1052 1225 1226 1227 1228 1229 1233 1258 1259 1260 1261 1262 1263 1264 1265 1266 1267 1268 1269 1270 1271 1272 1273 1274 1275 1276 1277 1278 1279 1280 1281 1282 1283 1284 1285 1286 1287 1288 1289 1290 1291 2097 2098 2099 2100 2102 2103 2104 2105 2106 2107 2108 2109 2110 2111 2112 2113 2114 2115 2116 2117 2118 2119 2120 2121 2122 2123 2125 2126 2127 2128 2129 2130 2131 2132 2133 2134 2331 2332 2333 2334 2335 2336 2337 2338 2339 2340 2341 2342 2343 2344 2345 2346 2347 2348 2349 2350 2351 2352 2353 2354 2355 2356 2357 2358 2359 2360 2361 2362 2363 2364 2365 2366 2367 2368 2369 2370 2371 2372 2373 2374 2375 2376 2377 2378 2379 2380 2381 2382 2383 2384 2385 2386 2387 2388 2389 2390 2391 2392 2393 2394 2395 2396 2397 2398 2399 2400 2401 2402 2403 2404 2405 2406 2407 2408 2409 2410 2411 2412 2413 2414 2415 2416 2417 2418 2419 2420 2421 2422 2423 2424 2425 2426 2427 2428 2429 2430 2431 2432 2433 2434 2435 2436 2437 2438 2439 2440 2441 2442 2443 2444 2445 2446 2447 2448 2449 2450 2451 2452 2453 2454 2455 2456 2457 2458 2459 2460 2461 2462 2463 2464 2465 2466 2467 2468 2478 2479 2480 2481 2482 2483 2484 2485 2486 2487 2488 2489 2490 2491 2492 2493 2494 2495 2496 2497 2498 2499 2500 2501 2502 2503 3220 3221 3222 3223 3224 3225 3226 3227 3228 3229 3230 3231 3232 3233 3234 3235 3236 3237 3238 3239 3240 3241 3242 3243 3244 3245 3246 3247 3248 3249 3250 3251 3252 3253 3254 3255 3256 3257 3258 3259 3260 3261 3262 3263 3264 3265 3266 3268 3269 3270 3271 3272 3273 3274 3275 3276 3277 3278 3279 3280 3281 3282 3283 3284 3285 3286 3287 3288 3289 3290 3291 3292 3293 3294 3295 3296 3297 3298 3299 3300 3301 3302 3303 3304 3305 3306 3307 3308 3309 3310 3311 3312 3313 3314 3315 3316 3317 3318 3319 3320 3321 3322 3323 3324 3343
    
    # Wasteland
    647 654 657 658 667 665 666 670 668 699 719 718 675 674 678 689 684 694 700 709 738 745
}

#-------------------------------------------
# Pandaria
#-------------------------------------------
continent_pandaria = {
    1435 1437 1466 1718 1719 1720 1721 1722 1723 1724 1725 1726 1727 1728 1729 1730 1731 1732 1733 1734 1735 1736 1737 1738 1739 1740 1773 1774 1775 1776 1777 1778 1779 1780 1781 1782 1783 1784 1785 1786 1787 1788 1789 1790 1791 1792 1793 1794 1795 1796 1797 1798 1799 1800 1801 1802 1803 1804 1805 1806 1807 1808 1809 1810 1811 1812 1813 1814 1815 1816 1817 1818 1819 1820 1821 1822 1823 1824 1828 1829 1832 1833 1834 1835 1836 1837 1838 1839 1840 1841 1842 1843 1845 1846 1847 1848 1849 1850 1851 1852 1853 1854 1855 1856 1857 1858 1859 1860 1861 1862 1863 1864 1865 1866 1867 1868 1869 1870 1871 1872 1873 1874 1876 1877 1878 1879 1880 1881 1882 1883 1884 1885 1886 1887 1888 1889 1890 1891 1892 1893 1894 1895 1896 1897 1898 1899 1900 1901 1902 1903 1904 1905 1906 1907 1908 1909 1910 1911 1912 1913 1914 1915 1917 1918 1919 1920 2067 2068 2069 2070 2071 2072 2073 2074 2075 2076 2077 2078 2079 2080 3210 3211 3212 3213 3214 348 405 840 1206 1417
    
    # Wasteland
    765 818 770 768 813 798 793 786 823 819 831 910 909 912 907 906 905 871 886 877 861 847 854 857
}

#-------------------------------------------
# Outland
#-------------------------------------------
continent_outland = {
    1586 1587 1588 1589 1590 1591 1592 1593 1594 1595 1596 1597 1598 1599 1602 1603 1604 1605 1606 1607 1608 1609 1610 1611 1612 1613 1614 1615 1616 1617 1619 1620 1621 1622 1623 1624 1625 1626 1627 1628 1629 1630 1631 1632 1633 1634 1635 1636 1637 1638 1641 1642 1643 1644 1645 1646 1647 1648 1649 1650 1651 1652 1654 1655 1656 1657 1658 1661 1662 1663 1664 1665 1666 1667 1668 1669 1670 1671 1672 1673 1674 1675 1676 1677 1678 1679 1680 1681 1682 1683 1684 1685 1686 1687 1688 1689 1690 1691 1692 1693 1694 1695 1696 1697 1698 1699 1701 1702 1703 1704 1705 1706 1707 1708 1709 1710 1711 1712 1713 1714 1715 1716 1717 2028 2029 2030 2031 2032 2033 2034 2035 2036 2037 2038 2039 2040 2041 2042 2043 2044 2045 2046 2047 2048 2049 2050 2051 2052 2053 2054 2055 2056 2057 2058 2059 2060 2061 2062 2063 2064 2065 2066 2101 
    3696 3697 3698 3699 3700 3701 3702 3703 3704 3705 3706 3955 3956 3957 3958 3959 3960 3961 3962 3963 3964 3965
    
    # Wasteland
    1230 1211 1207 1212 1209 1210 1213 1215 1216 1217 1218 1219 1220 1222 1221 1223 1214 1224 1231
}

#-------------------------------------------
# Draenor
#-------------------------------------------
continent_draenor = {
    3748 3749 3750 3751 3752 3753 3754 3755 3756 3757 3758 3759 3760 3761 3762 3763 3764 3765 3766 3767 3768 3769 3770 3771 3772 3773 3774 3775 3776 3777 3778 3779 3780 3781 3782 3783 3784 3785 3786 3787 3788 3789 3790 3791 3792 3793 3794 3795 3796 3797 3798 3799 3800 3801 3802 3803 3804 3805 3806 3807 3808 3809 3810 3811 3812 3813 3814 3815 3816 3817 3818 3819 3820 3821 3822 3823 3824 3825 3826 3827 3828 3829 3830 3831 3832 3833 3834 3835 3836 3837 3838 3839 3840 3841 3842 3843 3844 3845 3846 3847 3848 3849 3850 3851 3852 3853 3854 3855 3856 3857 3858 3859 3860 3861 3862 3863 3864 3865 3866 3867 3868 3952 3953 3954
    
    # Wasteland
    3741
}

#-------------------------------------------
# Broken Isles
#-------------------------------------------
continent_broken_isles = {
    2634 2635 2636 2637 2638 2639 2640 2641 2642 2643 2644 2645 2646 2647 2648 2649 2650 2651 2652 2653 2654 2655 2656 2657 2658 2659 2660 2661 2662 2663 2664 2665 2666 2667 2668 2669 2670 2671 2672 2673 2674 2675 2676 2677 2678 2679 2680 2681 2682 2683 2684 2685 2686 2687 2688 2689 2690 2691 3178 3179 3180 3181 3182 3183 3184 3185 3186 3187 3188 3189 3190 3191 3192
    
    # Wasteland
    
}

#-------------------------------------------
# Zandalar
#-------------------------------------------
continent_zandalar = {
    1108 1110 1111 1112 1113 1114 1115 1116 1117 1118 1119 1120 1122 1123 1124 1126 1127 1128 1129 1130 1131 1132 1133 1135 1136 2469 2470 2471 2508 2509
    
    # Wasteland
    754 758 759
}

#-------------------------------------------
# Kul Tiras
#-------------------------------------------
continent_kul_tiras = {
    1 11 168 169 170 171 179 180 181 182 246 247 249 257 258 259 260 261 262 263 264 277 278 279 280 281
    
    # Wasteland
}

#-------------------------------------------
# Vash'jir
#-------------------------------------------
continent_vashjir = {
    3171 3172 3173 3174 3175 3176 3177
}

#-------------------------------------------
# Nazjatar
#-------------------------------------------
continent_nazjatar = {
    573 577 579 588 590 611 616 617 620 621 
}

#-------------------------------------------
# Kezan
#-------------------------------------------
continent_kezan = {
    1097 1098 1100 1101 1109 1106 1107 1103 1102 1104 1099 1105
    
    # Wasteland
    640
}

#-------------------------------------------
# Plunder Isle
#-------------------------------------------
continent_plunder_isle = {
    3207 3208 3209 2472
}

#-------------------------------------------
# Deepholm
#-------------------------------------------
continent_deepholm = {
    3157 3160 3158 2700 3159
}

#-------------------------------------------
# RNW
#-------------------------------------------
new_world = {
}