width = 5632
height = 2048

max_provinces = 3292

sea_starts = { 
	1 2 3 4 5 6 7 8 9 3076 12 13 14 15 16 17 18 19 20 21 22 23 24 25 26 27 28 29 30 31 32 33 34 35 36 37 38 39 40 41 42 43 44 45 46 47 48 49 50 51 52 53 54 55 56 57 58 59 60 61 62 63 64 65 66 67 68 69 70 71 72 73 74 75 76 77 78 
	79 80 81 82 83 84 85 86 87 88 89 90 91 92 93 94 95 96 97 98 99 100 101 102 103 104 105 106 107 108 109 110 111 112 113 114 115 116 117 118 119 120 121 122 123 124 125 126 127 128 129 130 131 132 133 134 135 136 137 138 139 
	140 141 142 143 144 145 146 147 148 149 150 151 152 153 154 155 156 157 158 159 160 161 162 163 164 165 166 167 168 169 170 171 172 173 174 175 176 177 178 179 180 181 182 183 184 185 186 187 188 189 190 191 192 193 194 195 
	196 197 198 199 200 201 202 203 204 205 206 207 208 209 210 211 212 213 214 215 216 217 218 219 220 221 222 223 224 225 226 227 228 229 230 231 232 233 234 235 236 237 238 239 240 241 242 243 244 245 246 247 248 249 250 251 
	252 253 254 255 256 257 258 259 260 261 262 263 264 265 266 267 268 269 270 271 272 273 274 275 276 277 278 279 280 281 282 283 284 285 286 287 288 289 290 291 292 293 294 295 296 297 298 299 300 301 302 303 304 305 306 307 
	308 309 310 311 312 313 314 315 316 317 318 319 320 321 322 323 324 325 326 327 328 329 330 331 332 333 334 335 336 337 338 339 340 341 342 343 344 345 346 347 348 349 350 351 352 353 369 370 371 372 373 374 375 376 377 378 
	379 380 381 382 383 384 385 386 387 388 389 390 391 392 393 394 395 396 397 398 399 400 401 402 403 404 405 406 407 408 409 410 411 412 413 414 415 417 418 419 420 421 422 423 424 425 426 427 428 429 430 431 432 433 434 435 
	436 437 438 439 440 441 442 443 444 445 446 447 449 450 451 452 453 454 455 456 457 458 459 460 461 462 463 464 465 466 467 468 469 470 471 478 479 484 485 487 490 491 492 496 497 498 500 501 504 1162 1163 1164 1165 1166 1167 
	1168 1169 1170 1171 1172 1173 1182 1183 1196 1200 1201 1202 1203 1204 1205 1206 1207 1215 1216 1217 1218 1244 1251 1254 1256 1294 1741 1742 1743 1744 1745 1746 1747 1748 1749 1750 1751 1752 1753 1754 1755 1756 1757 1758 1759 1760 1761 1766 
	1770 1771 1772 1830 1831 2016 2017 2081 2082 2083 2084 2085 2086 2087 2088 2089 2090 2091 2092 2093 2094 2095 2018 666 168 169 170 171 50 
}

lakes = {
	10  354 355 356 357 358 359 1174 1176 1177 1178 1179 1180 1181 1184 1185 1186 1187 1188 1189 1190 1191 1192 1193 1194 1197 1198 1208 1209 1211 1212 1214 1219 1220 1221 1222 1223 1224 1230 1231 1232 1234 1235 1236 1237 1238 
	1240 1241 1242 1243 1245 1246 1247 1250 1253 1257 1946 1947 1948 1950 2001 2002 2020 2021 2022 2023 2024 2025 2026 2027 1507 
    1767 3081 1762 1763 1764 1765 1768 1292 1293 1199 3193 3196 3201
}
only_used_for_random = {
	2208 1066 2096 1014 1023 1024 1030 1031 1036 1040 1049 1053 1059 1060 1062 1063 11 1162 1175 1195 1210 1213 1239 1248 1249 1252 1255 1388 1404 1437 1505 1506 1525 1653 1769 1916 2168 2170 2172 2175 2179 2187 2190 2510 2511  
	2513 2514 2515 2516 2517 2518 2519 2520 2521 2522 2523 2524 2525 2526 2527 2528 2529 2530 2531 2532 2533 2534 2535 2536 2537 2538 2539 2540 2541 2542 2543 2544 2545 2546 2547 2548 2549 2550 2551 2552 2553 2554 2555 2556 2557 
	2559 2560 2561 2562 2563 2564 2565 2566 2567 2568 2569 2570 2571 2572 2573 2574 2575 2576 2577 2578 2579 2580 2581 2582 2583 2584 2585 2586 2587 2588 2589 2590 2591 2592 2593 2594 2595 2596 2597 2598 2599 2600 2601 2602 2603 
	2604 2605 2606 2607 2608 2609 2610 2611 2612 2613 2614 2615 2616 2617 2618 2619 2620 2621 2622 2623 2624 2625 2626 2627 2628 2629 2630 2631 2632 2633 2692 2693 2694 2695 2696 2697 2698 2699  2701 2702 2703 2704 2705 2706 2707 
	2708 2709 2710 2711 2712 2713 2714 2715 2716 2717 2718 2719 2720 2721 2722 2723 2724 2725 2726 2727 2728 2729 2730 2731 2732 2733 2734 2735 2736 2737 2738 2739 2740 2741 2742 2743 2744 2745 2746 2747 2748 2749 2750 2751 2752 
	2753 2754 2755 2756 2757 2758 2759 2760 2761 2762 2763 2764 2765 2766 2767 2768 2769 2770 2771 2772 2773 2774 2775 2776 2777 2778 2779 2780 2781 2782 2783 2784 2785 2786 2787 2788 2789 2790 2791 2792 2793 2794 2795 2796 2797 
	2798 2799 2800 2801 2802 2803 2804 2805 2806 2807 2808 2809 2810 2811 2812 2813 2814 2815 2816 2817 2818 2819 2820 2821 2822 2823 2824 2825 2826 2827 2828 2829 2830 2831 2832 2833 2834 2835 2836 2837 2838 2839 2840 2841 2842 
	2843 2844 2845 2846 2847 2848 2849 2850 2851 2852 2853 2854 2855 2856 2857 2858 2859 2860 2861 2862 2863 2864 2865 2866 2867 2868 2869 2870 2871 2872 2873 2874 2875 2876 2877 2878 2879 2880 2881 2882 2883 2884 2885 2886 2887 
	2888 2889 2890 2891 2892 2893 2894 2895 2896 2897 2898 2899 2900 2901 2902 2903 2904 2905 2906 2907 2908 2909 2910 2911 2912 2913 2914 2915 2916 2917 2918 2919 2920 2921 2922 2923 2924 2925 2926 2927 2928 2929 2930 2931 2932 
	2933 2934 2935 2936 2937 2938 2939 2940 2941 2942 2943 2944 2945 2946 2947 2948 360 361 362 363 364 365 366 367 416 448 472 473 474 475 476 477 480 481 482 483 486 488 489 493 494 495 499 502 503 512 513 514 524 532 534 535 
	549 551 555 559 566 568 569 572 573 577 579 588 590 604 611 616 617 620 621 640 647 654 657 658 665 667 668 670 674 675 678 684 689 694 699 700 709 718 719 738 745 754 758 759 765 768 770 786 793 798 813 818 819 823 831 840 
	847 854 861 871 877 886 905 906 907 909 910 912 923 924 929 940 948 952 955 963 965 972 977 980 987 3091 3092 3093 3094 3095 3096 3097 3098 3099 3100 3101 3102 3103 3104 3105 3106 3107 3108 3109 3110 3111 3112 3113 3114 3115 
	3116 3117 3118 3119 3120 3121 3122 3123 3124 3125 3126 3127 3128 3129 3130 3131 3132 3133 3134 3135 3136 3137 3138 3139 3140 3141 3142 3143 3144 3145 3146 3147 3148 3149 3150 3151 3152 1108 1110 1111 1112 1113 1114 1115 1116 
	1117 1118 1119 1120 1121 1122 1123 1124 1126 1127 1128 1129 1130 1131 1132 1133 1135 1136 1138 1139 1141 1143 1144 1145 1146 1147 1148 1149 1150 1151 1152 1153 1154 1155 1156 1157 1158 1159 1160 1161 1410 1411 1412 1413 1414 
	1415 1416 1417 1418 1419 1424 1425 1427 1466 1478 1479 1480 1481 1500 1501 1502 1503 1504 1523 1524 1600 1601 1618 1639 1640 1659 1660 1700 1825 1826 1827 1963 2019 2124 2137 2473 3008 3046 3071 3153 368 508 857 2558 2512
    
    3207 3208 3209 3210 3211 3212 3213 3214 3215 3216 3217 3218 3219 3220 3221 3222 3223 3224 3225 3226 3227 3228 3229 3230 3231 3232 3233 3234 3235 3236 3237 3238 3239 3240 3241 3242 3243 3244 3245 3246 3247 3248 3249 3250 3251 3252 3253 3254 3255 3256 3257 3258 3259 3260 3261 3262 3263 3264 3265 3266 3267 3268 3269 3270 3271 3272 3273 3274 3275 3276 3277 3278 3279 3280 3281 3282 3283 3284 3285 3286 3287 3288 3289 3290 3291 
}

force_coastal = {
}

canal_definition = {
	name = "deeprun_tram" # Name of your great project.
	x = 1000                 # The x-coordinate of the top-left corner of your tile.
	y = 1000                 # The map height minus the y-coordinate of the bottom left corner of your tile.
}

canal_definition = {
	name = "dark_portal_1" # Name of your great project.
	x = 1000                 # The x-coordinate of the top-left corner of your tile.
	y = 1000                 # The map height minus the y-coordinate of the bottom left corner of your tile.
}

canal_definition = {
	name = "dark_portal_2" # Name of your great project.
	x = 1000                 # The x-coordinate of the top-left corner of your tile.
	y = 1000                 # The map height minus the y-coordinate of the bottom left corner of your tile.
}

definitions = "definition.csv"
provinces = "provinces.bmp"
positions = "positions.txt"
terrain = "terrain.bmp"
rivers = "rivers.bmp"
terrain_definition = "terrain.txt"
heightmap = "heightmap.bmp"
tree_definition = "trees.bmp"
continent = "continent.txt"
adjacencies = "adjacencies.csv"
climate = "climate.txt"
region = "region.txt"
superregion = "superregion.txt"
area = "area.txt"
provincegroup = "provincegroup.txt"
ambient_object = "ambient_object.txt"
seasons = "seasons.txt"
trade_winds = "trade_winds.txt"

# Define which indices in trees.bmp palette which should count as trees for automatic terrain assignment
tree = { 3 4 7 }
