
#mytestgroup = {
#	1 2 3
#}

blackrock_spawn = {
    1050 630 884 707 2180 994 2156 2155 2191
}

bleeding_hollow_spawn = {
    2171 814 869 836 853 2181 864 725 2176 938 2182 2161 921 2162
}

twilights_hammer_spawn = {
    1033 807 1043 553 1042 2174
}

shadow_council_spawn = {
    1035 1045 1034
}

twilight_hammer_draenei_holdings = {
    1706 1708 1707 1717 2058 1709 2057 1710
}

shadow_council_draenei_holdings = {
    2044 1648 1649 2047 1568 1642 1641 1658
    1671 2037 1677 1669 1670 1679 1668 1667
}

north_kalimdor_provincegroup = {
    1325 1326 1324 2135 2136 # Moonglade
    1296 1295 1297 1298 1299 1300 1301 1302 1303 1304 2251 2252 2253 2254 2255 2256 # Darkshore
    1323 1331 1329 1327 1328 1330 1332 1333 2216 2217 2218 2219 2220 # Winterspring
    1322 1321 1320 1319 1318 1317 1316 1315 1314 2221 2222 2223 2224 2225 2226 # Felwood
    1337 1335 1334 1336 1339 1338 1345 1347 1348 1340 1341 1342 1343 1344 1346 # Mount Hyjal
    1308 1309 1312 1310 1311 1313 1349 1350 1351 1354 1353 2227 2228 2229 2230 2231 2232 2233 2234 2235 2236 2237 2238 1307 1305 1306 # Ashenvale
    1434 1433 1435 1431 1432 1436 1430 1429 1428 2239 2240 2241 2242 2243 2244 2245 2246 2247 2248 2249 2250 # Azshara
    1070 1073 1069 1072 1068 1067 1071 1065  # Teldrassil
    1085 1084 1075 1074 1076 1078 1077 1081 1083 1082 1080 1079 2266 2267 2268 2269 2270 2271 2272 2273 2274 2275 # Bloodmyst Isle
    1086 1088 1089 1095 1087 1093 1090 1091 1092 1094 2258 2259 2260 2261 2262 2263 2264 2265 # Azuremyst Isle
}

central_kalimdor_provincegroup = {
    1377 1426 1379 1378 1381 1380 1383 1382 1384 1385 1352 2288 2289 2290 2291 2292 2293 2294 # Durotar
    1370 1371 1420 1368 1421 1372 1373 1375 1376 1443  2282 2283 2284 2285 1365 1409 1369 1422 # Northern Barrens
    1355 1359 1356 1358 1360 1386  1407 1366 1408 1367 1364 1363 1362 1405 1361 1357 1406 2277 2278 2279 2280 2281 # Stonetalon Mountains
    1400 1387  1389 1401 1392 1393 1391 1390 1397 1402 1396 1394 1398 1395 1403 1399 2298 2299 2300 2301 2302 # Desolace
    1467 1468 1469 1470 1473 1482 1471 1484 1445 1472 1474 1483 1476 1475 1477 2295 2296 2297 # Mulgore
    1439 1440 1442 1441 1444 1446 1447 1464 2287 2286 1374 1423 2949# Southern Barrens
    1448 1465 1451 1450 1461 1452 1463 1453 1455 1454 1462 1456 1438 2201 2950 2951 2952 2953# Dustwallow Marsh
}

south_kalimdor_provincegroup = {
    1457 1581 1460 1458 1459 1584 1583 1582 1580 1496 1550 1579 1585 2313 2314 2315 2316 2317 2318 2319 2320 1449 2311 # Thousand Needles
    1485 1497 1487 1486 1498 1488 1499 1490 1492 1491 1493 1495 1494 1489 2303 2304 2305 2306 2307 2308 2309 2310 2312 2504# Feralas
    1508 1509 1510 1511 1512 1513 1515 1514 1516 1519 1522 1517 1518  # Silithus
    1526 1528 1529 1530 1539 1534 1527 1535 1540 1533 1531 1532 1537 1536 # Un'goro Crater
    1541 1543 1542 1554 1545 1553 1544 1552 1548 1555 1546 1538 1547 1549 1551 2321 2322 2323 2324 2325 2326 2327 2328 # Tanaris
    1556 1557 1558 1575 1562 1559 1576 1570 1571 1569 1577 1578 1572 1573 1568 1574 1564 1563 1565 1566 1567 1561 1560 # Uldum
    1521 1520 2329 2330 # Ahn Qiraj
}

lordaeron_provincegroup = {
    690 521 760 724 705 2990 2991 2992 2993 2994 # Isle of Quel'Danas
    558 978 676 660 704 944 626 609 643 1064 960 520 575 540 593 961 892 2985 2986 2987 2988 2989 # Eversong Woods
    1029 1013 993 844 806 822 860 876 945 1012 1041 808 791 776 1039 1038 629 659 2977 2978 2979 2980 2981 2982 2983 2984 1222 # Ghostlands
    2209 2210 2211 2212 2213 2214 2215 # Zul'aman
    592 625 608 642 723 1921 743 729 507 932 1922 915 1011 1028 519 574 1054 928 891 778 875 539 557 992 2970 2971 2972 2973 2974 2975 2976 3072 3073 3074 3075 # Eastern Plaguelands
    790 607 591 1923 703 722 688 821 843 859 805 742 775 2968 2969 3069  # Western Plaguelands
    964 979 1044 1015 560 931 740 1928 543 528 1927 1925 1926 646 662 727 2954 2955 2956 2957 2958 2192 3058 3059 3068  # Tirisfal Glades
    648 731 677 711 663 746 671 702 672 686 685 1924 720 2959 2960 2961 2962 2963  # Silverpine Forest
    863 2964 773 2965 756 943 556 2966 3067 1010 518 3066 3061 3063 3062 3065 3064 3060 3070  # Alterac Mountains
    624 538 959 976 991 1027 741 721 845 1931 2967 2995 2996  # Hillsbrad Foothills
    914 505 525 848 757 809 789 774 962 927 908 890 820 842 858 804 3016 3017 3018 3019 3020 3021 # Gilneas
    2004 957 2003 2006 2005 2007 2009 2008 974 989 2011 2012 2010 2013 # Tol Barad
    691 # Zul'Dare
    570 2015 824 639 2014 3009 3010 3011 3012 3013 3014 3015 # Kul Tiras
    1000 966 1929 527 981 1934 673 1932 687 506 897 1937 1935 1936 641 623 606 1933 3000 3001 3002 3003 3004 3005 3006 3007 3047 # Arathi Highlands
    1930 889 644 926 763 942 975 958 990 1009 1026 1125 537 1938 517 2997 2998 2999 # The Hinterlands
}

khaz_modan_provincegroup = {
    874 788 1939 1940 999 516 536 554 571 1032 656 605 589 622 1055 580 3022 3023 3024 3025 3026 3027 3028 # The Wetlands
    841 803 1061 1025 878 925 787 873 856 888 802 610 1016 755 739 701 632 614 581 542 613 730 631 561 710 744 597 2164 # Twilight Highlands
    1942 1941 1047 792 1046 1137 655 552 1945 1048 1944 3029 3030 3031 3032 3033 3034 # Loch Modan
    515 988 1943 1134 1007 973 956 941 855 817 1949 801 839 872 1140 887 1951 1142 3035 3036 3037 3038 3039 3040 3041 3042 3043 3044 3045 3048 3049 3050 3051 3052 3053 # Dun Morogh
    1967 1979 1974 1978 1969 1971 1972 1973 1976 1975 1970 1968 1977  # Badlands
    1953 1954 1955 1956 1957 1958 1965 1959 1960 1966 1961 1964 1962  # Searing Gorge
    2506 2507
}

azeroth_provincegroup = {
    1952 1980 1981 1982 1983 1991 1984 1987 1986 1985 1990 1988 1989 3054 3055 3056 3057 # Burning Steppes
    1994 650 772 752 737 717 683 785 800 1992 816 838 669 1993  2199 2197 2198 2196 2194 2195 2163 2193 # Redridge Mountains
    2149 2202 2205 2207 2141 2204 2142 2203 2206 1022  # Stormwind
    661 954 1005 986 913 587 619 603 550 567 1058 533  2145 2146 2147 2148 2144 2143 2200 2140 2139 2138 # Elwynn Forest
    885 638 547 949 707 994 725 864 594 879 1995 2185 2160 2184 2183 2159 2157 2186 2155 2180 2156  2191  2181 2188 2158 2189  # Swamp of Sorrows
    884 630 1050 807 1045 1033 1034 1043 1042 553 1035 1037 869 814 836 853 2176   2174 2173 2171 # Blasted Lands
    938 953 921 2182 2162 2161  # Deadwind Pass
    1021 1004 903 1057 985 970 586 698 653 682 637 618 602 2153 2152 2151 2150 2178 2177  # Duskwood
    904 627 837 870 751 736 716 771 596 815 612 799 1999 784 2000 922  2169 2154  # Westfall
    1996 1997 601 585 636 652 681 697 715 750 735 783 565 1056 548 531 511 1020 1003 984 969 920 937 902 852 868 883 996 693 997 1998 2165 2166 2167 3077 3078 3079 3080 # Stranglethorn Vale
    2505
}

northrend_provincegroup = {
    983 510 1052 1019 1002 919 968 936 951 1260 1258 1261 1233 1259 881 900 866 850 1281 530 2117 2118 2116 2122 2121 2123 2120 2119 2125 2331 2332 2333 2334 2335 2336 2337 2338 2339 2340 2341 2342 2343 2344 2345 2346 2347 2348 # Borean Tundra
    1282 708 834 862 2129 2126 2128 2127 # Wintergrasp
    812 1283  796 781 748 545 733 529 982 509  1018 1051 713 563 634 599 583 679 935 995 2134 2131 2133 2132 2130 2396 2397 2398 2399 2400 2401 2402 2403 2404 2405 2406 2407 2408 2409 2410 2411 2412 2413 2414 2415 2416 2417 2418 2419 # Dragonblight
    766 578 826 595 939 1265 1264 971 762 692 916 526 1262 1263 2100 2098 2097 2115 2099 2349 2350 2351 2352 2353 2354 2355 2356 2357 2358 2359 # Sholazar Basin
    846 1225 761 1266 827 1226 1269 726 523 947 1267 1268 930 895 1270 911 829 777 628 576 830 998 901 2360 2361 2362 2363 2364 2365 2366 2367 2368 2369 2370 2371 2372 2373 2374 2375 2376 2377 2378 2379 2380 2381 # Icecrown
    522 645 1278 1277 896 1229 728 1227 1279 894 946 1280 541 764 828 1228 753 1286 1291 2382 2383 2384 2385 2386 2387 2388 2389 2390 2391 2392 2393 2394 2395 # Storm Peak
    1284 649 664 615 598 633 544 779 582 562 1285 1017 898 933 917 810 832 794 1287 2420 2421 2422 2423 2424 2425 2426 2427 2428 2429 2430 2431 2432 2433 2434 2435 2436 2437 2438 2439 2440 2441 2442 1274 # Zul'drak
    967 950 849 833 811 795 767 712 732 695 780 747 865 899 880 1289 918 2111 2112 2113 2114 934 2443 2444 2445 2446 2447 2448 2449 2450 2451 2452 2453 2454 2455 2456 2457 2458 # Grizzly Hills
    706 1271 893 1272 1273 1276 825 1275 # Crystal Song
    1288 651 680 835 635 734 600 1290 584 564 546 882 769 749 782 714 867 851 2110 2102 2103 797 2104 2107 2106 2108 2105 2109 2460 2461 2462 2463 2464 2465 2466 2467 2468 2459 696 # Howling Fjord
    
    2478 2479 2480 2481 2482 2483 2484 2485 2486 2487 2488 2489 
    2490 2491 2492 2493 2494 2495 2496 2497 2498 2499 2500 2501 2502 2503
    1247 1245 
}

outland_provincegroup = {
    1586 1587 1588 1589 1590 1591 1592 1593 1594 1595 1596 1597 1598 1599 1602 2028 2029 2030 2031 2032 2033 2034 2035 # Hellfire Peninsula
    2049 1606 1605 1604 1603 1608 1607 1609 1610 2062 2063 1611 1617 2064 1612 1620 1614 1613 1615 1616 2065 2066 2474 2475 2476 2477 1619 # Zangermarsh
    1652 1641 1642 2048 1643 1658 2043 2042 2041 1644 1654 1645 2038 2040 1651 2039 1646 1647 1655 2044 1648 2047 1656 1649 1657 2046 1650 2045 # Terokkar Forest
    1633 1634 2051 2052 1638 1631 2050 1632 1636 1628 1627 1629 1630 1635 1621 1626 1625 1623 1622 1624 1637  # Nagrand 
    1661 1674 1662 1663 1676 1675 1668 1679 1669 1678 1664 1665 1666 2036 1672 1673 1677 2037 1670 1671 1667 # Shadowmoon Valley
    1680 1681 1682 2053 1683 1684 1685 1686 1687 1688 1689 1690 2055 1692 1691 2054 1693 1694 1695 1696 1697 1699 1698 2101 # Blades Edge Mountain
    1704 1702 1701 2056 1703 1710 2057 1709 2058 1706 1707 1708 1717 1716 1715 2059 1705 1711 1712 1713 2060 1714 2061 # Netherstorm
}

pandaria_provincegroup = {
    1800 1801 1802 1806 # Hidden Valley
    1884 1885 1886 1887 1883 1882 1888 1891 1889 1890 # Isle of Thunder
    1920 # Isle of Giants
    1734 1735 1720 2068 1738 1718 2069 1739 2067 2070 2071 1721 1740 2072 1722 1723 1726 1727 1725 2076 2079 2073 1724 1733 2077 2080 2075 2074 1732 1729 1728 1730 1731 2078 1737 1719 1736 # Jade Forest
    1790 1786 1793 1804 1791 1792 1794 1796 1803 1795 1798 1797 1805 1799 1829 # Valley of the Four Winds
    1785 1773 1788 1775 1774 1776 1784 1777 1778 1779 1780 1781 1782 1787 1783 1789  # Krasarang Wilds
    1855 1838 1837 1844 1845 1836 1846 1834 1835 1847 1853 1848 1849 1851 1850 1833 1840 1852 1839 1854 1842 1841 1856 1857 1858 1832 1843 # Dread Wastes
    1819 1823 1815 1817 1816 1814 1813 1821 1812 1824 1811 1818 1809 1810 1822 1820 1807 1808 # Vale of Eternal Blossom
    1859 1860 1874 1873 1872 1864 1875 1865 1866 1870 1876 1861 1862 1877 1863 1878 1871 1867 1880 1881 1879 1868 1869 # Townlong Steppes
    1898 1911 1912 1908 1897 1910 1896 1895 1919 1894 1909 1907 1917 1918 1899 1914 1900 1906 1828 1893  1915 1901 1913 1902 1904 1903 1892 1905 # Kun Lai Summit
    
}

the_lost_isles_provincegroup = {
    1097 1098 1099 1100 1101 1109 1102 1104 1103 1105 1107 1106  # The Lost Isles
}

south_seas_provincegroup = {
    2469 2470 2471 # Zandalar
    2472 # Plunder Isle
}

draenor_provincegroup = {

}

every_province_including_seas = {
	1 2 3 4 5 6 7 8 9 10 11 12 13 14 15 16 17 18 19 20 21 22 23 24 25 26 27 28 29 30 31 32 33 34 35 36 37 38 39 40 41 42 43 44 45 46 47 48 49 50 51 52 53 54 55 56 57 58 59 60 61 62 63 64 65 66 67 68 69 70 71 72 73 74 75 76 77
	78 79 80 81 82 83 84 85 86 87 88 89 90 91 92 93 94 95 96 97 98 99 100 101 102 103 104 105 106 107 108 109 110 111 112 113 114 115 116 117 118 119 120 121 122 123 124 125 126 127 128 129 130 131 132 133 134 135 136 137 138 
	139 140 141 142 143 144 145 146 147 148 149 150 151 152 153 154 155 156 157 158 159 160 161 162 163 164 165 166 167 168 169 170 171 172 173 174 175 176 177 178 179 180 181 182 183 184 185 186 187 188 189 190 191 192 193 194 
	195 196 197 198 199 200 201 202 203 204 205 206 207 208 209 210 211 212 213 214 215 216 217 218 219 220 221 222 223 224 225 226 227 228 229 230 231 232 233 234 235 236 237 238 239 240 241 242 243 244 245 246 247 248 249 250 
	251 252 253 254 255 256 257 258 259 260 261 262 263 264 265 266 267 268 269 270 271 272 273 274 275 276 277 278 279 280 281 282 283 284 285 286 287 288 289 290 291 292 293 294 295 296 297 298 299 300 301 302 303 304 305 306
	307 308 309 310 311 312 313 314 315 316 317 318 319 320 321 322 323 324 325 326 327 328 329 330 331 332 333 334 335 336 337 338 339 340 341 342 343 344 345 346 347 348 349 350 351 352 353 354 355 356 357 358 359 360 361 362
	363 364 365 366 367 368 368 369 370 371 372 373 374 375 376 377 378 379 380 381 382 383 384 385 386 387 388 389 390 391 392 393 394 395 396 397 398 399 400 401 402 403 404 405 406 407 408 409 410 411 412 413 414 415 416 417
	418 419 420 421 422 423 424 425 426 427 428 429 430 431 432 433 434 435 436 437 438 439 440 441 442 443 444 445 446 447 448 449 450 451 452 453 454 455 456 457 458 459 460 461 462 463 464 465 466 467 468 469 470 471 472 473
	474 475 476 477 478 479 480 481 482 483 484 485 486 487 488 489 490 491 492 493 494 495 496 497 498 499 500 501 502 503 504 505 506 507 508 508 509 510 511 512 513 514 515 516 517 518 519 520 521 522 523 524 525 526 527 528
	529 530 531 532 533 534 535 536 537 538 539 540 541 542 543 544 545 546 547 548 549 550 551 552 553 554 555 556 557 558 559 560 561 562 563 564 565 566 567 568 569 570 571 572 573 573 574 575 576 577 578 579 580 581 582 583
	584 585 586 587 588 589 590 591 592 593 594 595 596 597 598 599 600 601 602 603 604 605 606 607 608 609 610 611 612 613 614 615 616 617 617 618 619 620 621 621 622 623 624 625 626 627 628 629 630 631 632 633 634 635 636 637
	638 639 640 641 642 643 644 645 646 647 648 649 650 651 652 653 654 655 656 657 658 658 659 660 661 662 663 664 665 666 667 668 668 669 670 671 672 673 674 675 675 676 677 678 679 680 681 682 683 684 685 686 687 688 689 690
	691 692 693 694 695 696 697 698 699 700 700 701 702 703 704 705 706 707 708 709 710 711 712 713 714 715 716 717 718 719 719 720 721 722 723 724 725 726 727 728 729 730 731 732 733 734 735 736 737 738 739 740 741 742 743 744
	745 746 747 748 749 750 751 752 753 754 755 756 757 758 759 759 760 761 762 763 764 765 766 767 768 769 770 771 772 773 774 775 776 777 778 779 780 781 782 783 784 785 786 787 788 789 790 791 792 793 794 795 796 797 798 799
	800 801 802 803 804 805 806 807 808 809 810 811 812 813 814 815 816 817 818 819 819 820 821 822 823 824 825 826 827 828 829 830 831 832 833 834 835 836 837 838 839 840 841 842 843 844 845 846 847 848 849 850 851 852 853 854
	855 856 857 858 859 860 861 862 863 864 865 866 867 868 869 870 871 872 873 874 875 876 877 878 879 880 881 882 883 884 885 886 887 888 889 890 891 892 893 894 895 896 897 898 899 900 901 902 903 904 905 906 906 907 908 909
	910 910 911 912 913 914 915 916 917 918 919 920 921 922 923 924 924 925 926 927 928 929 930 931 932 933 934 935 936 937 938 939 940 941 942 943 944 945 946 947 948 949 950 951 952 953 954 955 956 957 958 959 960 961 962 963
	964 965 966 967 968 969 970 971 972 973 974 975 976 977 978 979 980 981 982 983 984 985 986 987 988 989 990 991 992 993 994 995 996 997 998 999 1000 1001 1002 1003 1004 1005 1006 1007 1008 1009 1010 1011 1012 1013 1014 1015
	1016 1017 1018 1019 1020 1021 1022 1023 1024 1024 1025 1026 1027 1028 1029 1030 1031 1031 1032 1033 1034 1035 1036 1037 1038 1039 1040 1041 1042 1043 1044 1045 1046 1047 1048 1049 1050 1051 1052 1053 1054 1055 1056 1057 1058
	1059 1060 1060 1061 1062 1063 1063 1064 1065 1067 1068 1069 1070 1071 1072 1073 1074 1075 1076 1077 1078 1079 1080 1081 1082 1083 1084 1085 1086 1087 1088 1089 1090 1091 1092 1093 1094 1095 1096 1097 1098 1099 1100 1101 1102
	1103 1104 1105 1106 1107 1108 1109 1110 1110 1111 1112 1112 1113 1114 1114 1115 1116 1116 1117 1117 1118 1119 1119 1120 1120 1121 1122 1122 1123 1124 1124 1125 1126 1126 1127 1127 1128 1128 1129 1129 1130 1130 1131 1132 1132
	1133 1134 1135 1136 1136 1137 1138 1139 1139 1140 1141 1142 1143 1144 1144 1145 1146 1146 1147 1147 1148 1149 1149 1150 1151 1151 1152 1153 1153 1154 1155 1155 1156 1157 1157 1158 1159 1159 1160 1161 1161 1162 1162 1163 1164
	1165 1166 1167 1168 1169 1170 1171 1172 1173 1174 1175 1176 1177 1178 1179 1180 1181 1182 1183 1184 1185 1186 1187 1188 1189 1190 1191 1192 1193 1194 1195 1196 1197 1198 1199 1200 1201 1202 1203 1204 1205 1206 1207 1208 1209
	1210 1211 1212 1213 1214 1215 1216 1217 1218 1219 1220 1221 1222 1223 1224 1225 1226 1227 1228 1229 1230 1231 1232 1233 1234 1235 1236 1237 1238 1239 1240 1241 1242 1243 1244 1245 1246 1247 1248 1249 1249 1250 1251 1252 1253
	1254 1255 1256 1257 1258 1259 1260 1261 1262 1263 1264 1265 1266 1267 1268 1269 1270 1271 1272 1273 1274 1275 1276 1277 1278 1279 1280 1281 1282 1283 1284 1285 1286 1287 1288 1289 1290 1291 1292 1293 1294 1295 1296 1297 1298
	1299 1300 1301 1302 1303 1304 1305 1306 1307 1308 1309 1310 1311 1312 1313 1314 1315 1316 1317 1318 1319 1320 1321 1322 1323 1324 1325 1326 1327 1328 1329 1330 1331 1332 1333 1334 1335 1336 1337 1338 1339 1340 1341 1342 1343
	1344 1345 1346 1347 1348 1349 1350 1351 1352 1353 1354 1355 1356 1357 1358 1359 1360 1361 1362 1363 1364 1365 1366 1367 1368 1369 1370 1371 1372 1373 1374 1375 1376 1377 1378 1379 1380 1381 1382 1383 1384 1385 1386 1387 1388
	1389 1390 1391 1392 1393 1394 1395 1396 1397 1398 1399 1400 1401 1402 1403 1404 1405 1406 1407 1408 1409 1410 1411 1411 1412 1413 1413 1414 1414 1415 1415 1416 1417 1417 1418 1419 1419 1420 1421 1422 1423 1424 1425 1425 1426
	1427 1428 1429 1430 1431 1432 1433 1434 1435 1436 1437 1438 1439 1440 1441 1442 1443 1444 1445 1446 1447 1448 1449 1450 1451 1452 1453 1454 1455 1456 1457 1458 1459 1460 1461 1462 1463 1464 1465 1466 1467 1468 1469 1470 1471
	1472 1473 1474 1475 1476 1477 1478 1479 1479 1480 1481 1481 1482 1483 1484 1485 1486 1487 1488 1489 1490 1491 1492 1493 1494 1495 1496 1497 1498 1499 1500 1501 1501 1502 1503 1503 1504 1505 1505 1506 1507 1508 1509 1510 1511
	1512 1513 1514 1515 1516 1517 1518 1519 1520 1521 1522 1523 1524 1524 1525 1526 1527 1528 1529 1530 1531 1532 1533 1534 1535 1536 1537 1538 1539 1540 1541 1542 1543 1544 1545 1546 1547 1548 1549 1550 1551 1552 1553 1554 1555
	1556 1557 1558 1559 1560 1561 1562 1563 1564 1565 1566 1567 1568 1569 1570 1571 1572 1573 1574 1575 1576 1577 1578 1579 1580 1581 1582 1583 1584 1585 1586 1587 1588 1589 1590 1591 1592 1593 1594 1595 1596 1597 1598 1599 1600
	1600 1601 1602 1603 1604 1605 1606 1607 1608 1609 1610 1611 1612 1613 1614 1615 1616 1617 1618 1619 1620 1621 1622 1623 1624 1625 1626 1627 1628 1629 1630 1631 1632 1633 1634 1635 1636 1637 1638 1639 1640 1640 1641 1642 1643
	1644 1645 1646 1647 1648 1649 1650 1651 1652 1653 1654 1655 1656 1657 1658 1659 1660 1660 1661 1662 1663 1664 1665 1666 1667 1668 1669 1670 1671 1672 1673 1674 1675 1676 1677 1678 1679 1680 1681 1682 1683 1684 1685 1686 1687
	1688 1689 1690 1691 1692 1693 1694 1695 1696 1697 1698 1699 1700 1700 1701 1702 1703 1704 1705 1706 1707 1708 1709 1710 1711 1712 1713 1714 1715 1716 1717 1718 1719 1720 1721 1722 1723 1724 1725 1726 1727 1728 1729 1730 1731
	1732 1733 1734 1735 1736 1737 1738 1739 1740 1741 1742 1743 1744 1745 1746 1747 1748 1749 1750 1751 1752 1753 1754 1755 1756 1757 1758 1759 1760 1761 1762 1763 1764 1765 1766 1767 1768 1769 1770 1771 1772 1773 1774 1775 1776
	1777 1778 1779 1780 1781 1782 1783 1784 1785 1786 1787 1788 1789 1790 1791 1792 1793 1794 1795 1796 1797 1798 1799 1800 1801 1802 1803 1804 1805 1806 1807 1808 1809 1810 1811 1812 1813 1814 1815 1816 1817 1818 1819 1820 1821
	1822 1823 1824 1825 1826 1826 1827 1828 1829 1830 1831 1832 1833 1834 1835 1836 1837 1838 1839 1840 1841 1842 1843 1844 1845 1846 1847 1848 1849 1850 1851 1852 1853 1854 1855 1856 1857 1858 1859 1860 1861 1862 1863 1864 1865
	1866 1867 1868 1869 1870 1871 1872 1873 1874 1875 1876 1877 1878 1879 1880 1881 1882 1883 1884 1885 1886 1887 1888 1889 1890 1891 1892 1893 1894 1895 1896 1897 1898 1899 1900 1901 1902 1903 1904 1905 1906 1907 1908 1909 1910
	1911 1912 1913 1914 1915 1916 1917 1918 1919 1920 1921 1922 1923 1924 1925 1926 1927 1928 1929 1930 1931 1932 1933 1934 1935 1936 1937 1938 1939 1940 1941 1942 1943 1944 1945 1946 1947 1948 1949 1950 1951 1952 1953 1954 1955
	1956 1957 1958 1959 1960 1961 1962 1963 1963 1964 1965 1966 1967 1968 1969 1970 1971 1972 1973 1974 1975 1976 1977 1978 1979 1980 1981 1982 1983 1984 1985 1986 1987 1988 1989 1990 1991 1992 1993 1994 1995 1996 1997 1998 1999
	2000 2001 2002 2003 2004 2005 2006 2007 2008 2009 2010 2011 2012 2013 2014 2015 2016 2017 2018 2019 2019 2020 2021 2022 2023 2024 2025 2026 2027 2028 2029 2030 2031 2032 2033 2034 2035 2036 2037 2038 2039 2040 2041 2042 2043
	2044 2045 2046 2047 2048 2049 2050 2051 2052 2053 2054 2055 2056 2057 2058 2059 2060 2061 2062 2063 2064 2065 2066 2067 2068 2069 2070 2071 2072 2073 2074 2075 2076 2077 2078 2079 2080 2081 2082 2083 2084 2085 2086 2087 2088
	2089 2090 2091 2092 2093 2094 2095 2096 2097 2098 2099 2100 2101 2102 2103 2104 2105 2106 2107 2108 2109 2110 2111 2112 2113 2114 2115 2116 2117 2118 2119 2120 2121 2122 2123 2124 2125 2126 2127 2128 2129 2130 2131 2132 2133
	2134 2135 2136 2137 2137 2138 2139 2140 2141 2142 2143 2144 2145 2146 2147 2148 2149 2150 2151 2152 2153 2154 2155 2156 2157 2158 2159 2160 2161 2162 2163 2164 2165 2166 2167 2168 2169 2170 2171 2172 2173 2174 2175 2176 2177
	2178 2179 2180 2181 2182 2183 2184 2185 2186 2187 2188 2189 2190 2191 2192 2193 2194 2195 2196 2197 2198 2199 2200 2201 2202 2203 2204 2205 2206 2207 2209 2210 2211 2212 2213 2214 2215 2216 2217 2218 2219 2220 2221 2222 2223
	2224 2225 2226 2227 2228 2229 2230 2231 2232 2233 2234 2235 2236 2237 2238 2239 2240 2241 2242 2243 2244 2245 2246 2247 2248 2249 2250 2251 2252 2253 2254 2255 2256 2257 2258 2259 2260 2261 2262 2263 2264 2265 2266 2267 2268
	2269 2270 2271 2272 2273 2274 2275 2276 2277 2278 2279 2280 2281 2282 2283 2284 2285 2286 2287 2288 2289 2290 2291 2292 2293 2294 2295 2296 2297 2298 2299 2300 2301 2302 2303 2304 2305 2306 2307 2308 2309 2310 2311 2312 2313
	2314 2315 2316 2317 2318 2319 2320 2321 2322 2323 2324 2325 2326 2327 2328 2329 2330 2331 2332 2333 2334 2335 2336 2337 2338 2339 2340 2341 2342 2343 2344 2345 2346 2347 2348 2349 2350 2351 2352 2353 2354 2355 2356 2357 2358
	2359 2360 2361 2362 2363 2364 2365 2366 2367 2368 2369 2370 2371 2372 2373 2374 2375 2376 2377 2378 2379 2380 2381 2382 2383 2384 2385 2386 2387 2388 2389 2390 2391 2392 2393 2394 2395 2396 2397 2398 2399 2400 2401 2402 2403
	2404 2405 2406 2407 2408 2409 2410 2411 2412 2413 2414 2415 2416 2417 2418 2419 2420 2421 2422 2423 2424 2425 2426 2427 2428 2429 2430 2431 2432 2433 2434 2435 2436 2437 2438 2439 2440 2441 2442 2443 2444 2445 2446 2447 2448
	2449 2450 2451 2452 2453 2454 2455 2456 2457 2458 2459 2460 2461 2462 2463 2464 2465 2466 2467 2468 2469 2470 2471 2472 2473 2474 2475 2476 2477 2478 2479 2480 2481 2482 2483 2484 2485 2486 2487 2488 2489 2490 2491 2492 2493
	2494 2495 2496 2497 2498 2499 2500 2501 2502 2503 2504 2505 2506 2507 2508 2509 2510 2510 2511 2512 2513 2514 2515 2516 2517 2518 2519 2520 2521 2522 2523 2524 2525 2526 2527 2528 2529 2530 2531 2532 2533 2534 2535 2536 2537
	2538 2539 2540 2541 2542 2543 2544 2545 2546 2547 2548 2549 2550 2551 2552 2553 2554 2555 2556 2557 2558 2559 2560 2561 2562 2563 2564 2565 2566 2567 2568 2569 2570 2571 2572 2573 2574 2575 2576 2577 2578 2579 2580 2581 2582
	2583 2584 2585 2586 2587 2588 2589 2590 2591 2592 2593 2594 2595 2596 2597 2598 2599 2600 2601 2602 2603 2604 2605 2606 2607 2608 2609 2610 2611 2612 2613 2614 2615 2616 2617 2618 2619 2620 2621 2622 2623 2624 2625 2626 2627
	2628 2629 2630 2631 2632 2633 1066 2634 2635 2636 2637 2638 2639 2640 2641 2642 2643 2644 2645 2646 2647 2648 2649 2650 2651 2652 2653 2654 2655 2656 2657 2658 2659 2660 2661 2662 2663 2664 2665 2666 2667 2668 2669 2670 2671
	2672 2673 2674 2675 2676 2677 2678 2679 2680 2681 2682 2683 2684 2685 2686 2687 2688 2689 2690 2691 2692 2693 2694 2695 2696 2697 2698 2699 2701 2702 2703 2704 2705 2706 2707 2708 2709 2710 2711 2712 2713 2714 2715 2716 2717
	2718 2719 2720 2721 2722 2723 2724 2725 2726 2727 2728 2729 2730 2731 2732 2733 2734 2735 2736 2737 2738 2739 2740 2741 2742 2743 2744 2745 2746 2747 2748 2749 2750 2751 2752 2753 2754 2755 2756 2757 2758 2759 2760 2761 2762
	2763 2764 2765 2766 2767 2768 2769 2770 2771 2772 2773 2774 2775 2776 2777 2778 2779 2780 2781 2782 2783 2784 2785 2786 2787 2788 2789 2790 2791 2792 2793 2794 2795 2796 2797 2798 2799 2800 2801 2802 2803 2804 2805 2806 2807
	2808 2809 2810 2811 2812 2813 2814 2815 2816 2817 2818 2819 2820 2821 2822 2823 2824 2825 2826 2827 2828 2829 2830 2831 2832 2833 2834 2835 2836 2837 2838 2839 2840 2841 2842 2843 2844 2845 2846 2847 2848 2849 2850 2851 2852
	2853 2854 2855 2856 2857 2858 2859 2860 2861 2862 2863 2864 2865 2866 2867 2868 2869 2870 2871 2872 2873 2874 2875 2876 2877 2878 2879 2880 2881 2882 2883 2884 2885 2886 2887 2888 2889 2890 2891 2892 2893 2894 2895 2896 2897
	2898 2899 2900 2901 2902 2903 2904 2905 2906 2907 2908 2909 2910 2911 2912 2913 2914 2915 2916 2917 2918 2919 2920 2921 2922 2923 2924 2925 2926 2927 2928 2929 2930 2931 2932 2933 2934 2935 2936 2937 2938 2939 2940 2941 2942
	2943 2944 2945 2946 2947 2948 2949 2950 2951 2952 2953 2954 2955 2956 2957 2958 2959 2960 2961 2962 2963 2964 2965 2966 2967 2968 2969 2970 2971 2972 2973 2974 2975 2976 2977 2978 2979 2980 2981 2982 2983 2984 2985 2986 2987
	2988 2989 2990 2991 2992 2993 2994 2995 2996 2997 2998 2999 3000 3001 3002 3003 3004 3005 3006 3007 3008 3008 3009 3010 3011 3012 3013 3014 3015 3016 3017 3018 3019 3020 3021 3022 3023 3024 3025 3026 3027 3028 3029 3030 3031
	3032 3033 3034 3035 3036 3037 3038 3039 3040 3041 3042 3043 3044 3045 3046 3047 3048 3049 3050 3051 3052 3053 3054 3055 3056 3057 3058 3059 3060 3061 3062 3063 3064 3065 3066 3067 3068 3069 3070 3071 3071 3072 3073 3074 3075
	3076 3077 3078 3079 3080 3081 3082 3083 3084 3085 3086 3087 3088 3089 3090 3091 3092 3093 3094 3095 3096 3097 3098 3099 3100 3101 3102 3103 3104 3105 3106 3107 3108 3109 3110 3111 3112 3113 3114 3115 3116 3117 3118 3119 3120
	3121 3122 3123 3124 3125 3126 3127 3128 3129 3130 3131 3132 3133 3134 3135 3136 3137 3138 3139 3140 3141 3142 3143 3144 3145 3146 3147 3148 3149 3150 3151 3152 3153 2208 2700 3154 3155 3156 3157 3158 3159 3160 3161 3162 3163
	3164 3165 3166 3167 3168 3169 3170 3171 3172 3173 3174 3175 3176 3177 3178 3179 3180 3181 3182 3183 3184 3185 3186 3187 3188 3189 3190 3191 3192 3193 3194 3195 3196 3197 3198 3199 3200 3201 3202 3203 3204 3205 3206 3207 3208 3209 3210 3211 3212 3213 3214 3215 3216 3217 3218 3219 1014
}