blackrock_spawn = {
    1050 630 884 707 2180 994 2156 2155 2191
}

bleeding_hollow_spawn = {
    2171 814 869 836 853 2181 864 725 2176 938 2182 2161 921 2162
}

twilights_hammer_spawn = {
    1033 807 1043 553 1042 2174
}

shadow_council_spawn = {
    1035 1045 1034
}

twilight_hammer_draenei_holdings = {
    1706 1708 1707 1717 2058 1709 2057 1710
}

shadow_council_draenei_holdings = {
    2044 1648 1649 2047 1568 1642 1641 1658
    1671 2037 1677 1669 1670 1679 1668 1667
}

wastelands_pg = {
    368 508 604 640 647 654 657 658 665 666 667 668 670 674 675 678 684 689 694 699 700 709 718 719 738 745 754 758 759 765 768 770 786 793 798 813 818 819 823 831 840 847 854 857 861 871 877 886 905 906 907 909 910 912 923 924 929 940 948 952 955 963 965 972 977 980 987 1008 1023 1024 1030 1031 1036 1040 1049 1053 1059 1060 1062 1063 1066 1096 1121 1138 1139 1141 1143 1144 1145 1146 1147 1148 1149 1150 1151 1152 1153 1154 1155 1156 1157 1158 1159 1160 1161 1162 1163 1164 1165 1166 1167 1168 1169 1170 1171 1172 1173 1174 1175 1176 1177 1178 1179 1180 1181 1182 1183 1184 1185 1186 1187 1188 1189 1190 1191 1192 1193 1194 1195 1196 1197 1198 1199 1200 1201 1202 1203 1204 1205 1206 1207 1208 1209 1210 1211 1212 1213 1214 1215 1216 1217 1218 1219 1220 1221 1222 1223 1224 1230 1231 1232 1411 1413 1414 1415 1417 1419 1425 1479 1481 1501 1503 1524 1600 1640 1660 1700 1826 1963 2019 2137 2257 2276 3071 3375 3376 3377 3378 3379 3380 3381 3382 3383 3384 3385 3386 3387 3388 3389 3390 3391 3392 3393 3394 3430 3431 3432 3433 3476
}

lakes_pg = {
    
}

pg_uncolonizable = {
    
}